REPORTE PÁGINA WEB: https://www.iberdrola.es/informacion/alta-nuevo-suministro-gas
FECHA EVALUACIÓN: 2018-11-13

PROBLEMAS
Empty link	  VECES ENCONTRADO: 4
Linked image missing alternative text	  VECES ENCONTRADO: 3



ALERTAS
Underlined text	  VECES ENCONTRADO: 4
A nearby image has the same alternative text	  VECES ENCONTRADO: 4
Redundant link	  VECES ENCONTRADO: 6
Orphaned form label	  VECES ENCONTRADO: 10
Possible heading	  VECES ENCONTRADO: 1
Redundant alternative text	  VECES ENCONTRADO: 7
Redundant title text	  VECES ENCONTRADO: 16
Justified text	  VECES ENCONTRADO: 18
Noscript element	  VECES ENCONTRADO: 2



CARACTERISTICAS
Linked image with alternative text	  VECES ENCONTRADO: 11
Element language	  VECES ENCONTRADO: 3
Null or empty alternative text	  VECES ENCONTRADO: 53
Alternative text	  VECES ENCONTRADO: 4
Form label	  VECES ENCONTRADO: 2



PROBLEMAS DE CONTRASTE
Very Low Contrast	  VECES ENCONTRADO: 16



