REPORTE PÁGINA WEB: http://www.mscbs.gob.es/
FECHA EVALUACIÓN: 2018-12-19

-PROBLEMAS-

Empty button	  VECES ENCONTRADO: 3
Broken ARIA reference	  VECES ENCONTRADO: 27


-ALERTAS-

Noscript element	  VECES ENCONTRADO: 1
Skipped heading level	  VECES ENCONTRADO: 1
A nearby image has the same alternative text	  VECES ENCONTRADO: 2
Orphaned form label	  VECES ENCONTRADO: 1
Redundant link	  VECES ENCONTRADO: 2
Possible heading	  VECES ENCONTRADO: 5
Redundant title text	  VECES ENCONTRADO: 3
Link to PDF document	  VECES ENCONTRADO: 8


-CARACTERISTICAS-

Element language	  VECES ENCONTRADO: 12
Null or empty alternative text	  VECES ENCONTRADO: 44
Null or empty alternative text on spacer	  VECES ENCONTRADO: 1
Linked image with alternative text	  VECES ENCONTRADO: 97


-PROBLEMAS DE CONTRASTE-

Very Low Contrast	  VECES ENCONTRADO: 6


