REPORTE PÁGINA WEB: http://www.mscbs.gob.es/estadEstudios/sanidadDatos/home.htm
FECHA EVALUACIÓN: 2018-11-21

PROBLEMAS
Empty button	  VECES ENCONTRADO: 4
Missing alternative text	  VECES ENCONTRADO: 13



ALERTAS
Device dependent event handler	  VECES ENCONTRADO: 1
Noscript element	  VECES ENCONTRADO: 1
Redundant title text	  VECES ENCONTRADO: 3
Redundant link	  VECES ENCONTRADO: 9
Orphaned form label	  VECES ENCONTRADO: 1
Link to PDF document	  VECES ENCONTRADO: 3



CARACTERISTICAS
Null or empty alternative text	  VECES ENCONTRADO: 19
Alternative text	  VECES ENCONTRADO: 2
Long description	  VECES ENCONTRADO: 3
Linked image with alternative text	  VECES ENCONTRADO: 23
Element language	  VECES ENCONTRADO: 12



PROBLEMAS DE CONTRASTE
Very Low Contrast	  VECES ENCONTRADO: 1



