REPORTE PÁGINA WEB: http://www.ciencia.gob.es/portal/site/MICINN/contacto
FECHA EVALUACIÓN: 2018-11-08

PROBLEMAS
Missing alternative text	  VECES ENCONTRADO: 3
Empty link	  VECES ENCONTRADO: 2



ALERTAS
Justified text	  VECES ENCONTRADO: 30
Broken same-page link	  VECES ENCONTRADO: 1
Redundant title text	  VECES ENCONTRADO: 11
Accesskey	  VECES ENCONTRADO: 6
Redundant link	  VECES ENCONTRADO: 3
Possible heading	  VECES ENCONTRADO: 1



CARACTERISTICAS
Form label	  VECES ENCONTRADO: 1
Linked image with alternative text	  VECES ENCONTRADO: 7
Null or empty alternative text	  VECES ENCONTRADO: 3
Alternative text	  VECES ENCONTRADO: 1
Element language	  VECES ENCONTRADO: 5
Image button with alternative text	  VECES ENCONTRADO: 1



PROBLEMAS DE CONTRASTE
Very Low Contrast	  VECES ENCONTRADO: 20



