REPORTE PÁGINA WEB: http://www.mecd.gob.es/cultura-mecd/areas-cultura/cooperacion.html
FECHA EVALUACIÓN: 2018-11-23

PROBLEMAS
Empty button	  VECES ENCONTRADO: 4



ALERTAS
A nearby image has the same alternative text	  VECES ENCONTRADO: 2
Long alternative text	  VECES ENCONTRADO: 1
Justified text	  VECES ENCONTRADO: 2
Noscript element	  VECES ENCONTRADO: 1
Redundant link	  VECES ENCONTRADO: 1
Redundant title text	  VECES ENCONTRADO: 3
Broken same-page link	  VECES ENCONTRADO: 1
Redundant alternative text	  VECES ENCONTRADO: 2



CARACTERISTICAS
Alternative text	  VECES ENCONTRADO: 1
Null or empty alternative text on spacer	  VECES ENCONTRADO: 2
Linked image with alternative text	  VECES ENCONTRADO: 35
Null or empty alternative text	  VECES ENCONTRADO: 5
Fieldset	  VECES ENCONTRADO: 1
Element language	  VECES ENCONTRADO: 6
Form label	  VECES ENCONTRADO: 1



PROBLEMAS DE CONTRASTE
Very Low Contrast	  VECES ENCONTRADO: 1



