REPORTE PÁGINA WEB: https://www.uv.es/uvweb/universitat/ca/estudis-postgrau/masters-oficials/novetats-1286020074544.html
FECHA EVALUACIÓN: 2018-11-11

PROBLEMAS
Empty heading	  VECES ENCONTRADO: 1
Linked image missing alternative text	  VECES ENCONTRADO: 1
Missing alternative text	  VECES ENCONTRADO: 3
Empty link	  VECES ENCONTRADO: 7



ALERTAS
Link to PDF document	  VECES ENCONTRADO: 8
Very small text	  VECES ENCONTRADO: 4
Noscript element	  VECES ENCONTRADO: 5
Redundant title text	  VECES ENCONTRADO: 57
Justified text	  VECES ENCONTRADO: 33
Accesskey	  VECES ENCONTRADO: 1
Redundant alternative text	  VECES ENCONTRADO: 1
Redundant link	  VECES ENCONTRADO: 11



CARACTERISTICAS
Form label	  VECES ENCONTRADO: 1
Null or empty alternative text	  VECES ENCONTRADO: 1
Alternative text	  VECES ENCONTRADO: 3
Linked image with alternative text	  VECES ENCONTRADO: 23



PROBLEMAS DE CONTRASTE
Very Low Contrast	  VECES ENCONTRADO: 11



