REPORTE PÁGINA WEB: http://www.aemet.es/es/conocenos/congresos_y_conferencias
FECHA EVALUACIÓN: 2018-11-19

PROBLEMAS
Empty link	  VECES ENCONTRADO: 2
Empty form label	  VECES ENCONTRADO: 2



ALERTAS
Long alternative text	  VECES ENCONTRADO: 1
Device dependent event handler	  VECES ENCONTRADO: 1
Justified text	  VECES ENCONTRADO: 2
Very small text	  VECES ENCONTRADO: 6
Skipped heading level	  VECES ENCONTRADO: 1
Accesskey	  VECES ENCONTRADO: 8
Redundant link	  VECES ENCONTRADO: 2
Redundant title text	  VECES ENCONTRADO: 26



CARACTERISTICAS
Linked image with alternative text	  VECES ENCONTRADO: 25
Form label	  VECES ENCONTRADO: 2
Alternative text	  VECES ENCONTRADO: 3
Element language	  VECES ENCONTRADO: 14



PROBLEMAS DE CONTRASTE
Very Low Contrast	  VECES ENCONTRADO: 12



