REPORTE PÁGINA WEB: http://www.alicante.es/es/contenidos/transporte-alicante-metropolitano-tam
FECHA EVALUACIÓN: 2018-10-31

PROBLEMAS
Missing form label	  VECES ENCONTRADO: 1
Empty button	  VECES ENCONTRADO: 4
Empty link	  VECES ENCONTRADO: 7



ALERTAS
Underlined text	  VECES ENCONTRADO: 3
Link to PDF document	  VECES ENCONTRADO: 4
A nearby image has the same alternative text	  VECES ENCONTRADO: 1
Justified text	  VECES ENCONTRADO: 247
Redundant title text	  VECES ENCONTRADO: 2
Redundant link	  VECES ENCONTRADO: 2



CARACTERISTICAS
Null or empty alternative text	  VECES ENCONTRADO: 4
Fieldset	  VECES ENCONTRADO: 1
Element language	  VECES ENCONTRADO: 2
Alternative text	  VECES ENCONTRADO: 1
Linked image with alternative text	  VECES ENCONTRADO: 2



PROBLEMAS DE CONTRASTE
Very Low Contrast	  VECES ENCONTRADO: 9



