REPORTE PÁGINA WEB: http://www.renfe.com
FECHA EVALUACIÓN: 2018-12-06

-PROBLEMAS-

Broken ARIA reference	  VECES ENCONTRADO: 11


-ALERTAS-

Fieldset missing legend	  VECES ENCONTRADO: 2
Redundant link	  VECES ENCONTRADO: 4
Noscript element	  VECES ENCONTRADO: 1
A nearby image has the same alternative text	  VECES ENCONTRADO: 1
Underlined text	  VECES ENCONTRADO: 1
Tabindex	  VECES ENCONTRADO: 1
Very small text	  VECES ENCONTRADO: 16
Redundant title text	  VECES ENCONTRADO: 11
Missing fieldset	  VECES ENCONTRADO: 2


-CARACTERISTICAS-

Element language	  VECES ENCONTRADO: 7
Fieldset	  VECES ENCONTRADO: 4
Linked image with alternative text	  VECES ENCONTRADO: 19
Form label	  VECES ENCONTRADO: 18
Alternative text	  VECES ENCONTRADO: 10
Null or empty alternative text	  VECES ENCONTRADO: 12


-PROBLEMAS DE CONTRASTE-

Very Low Contrast	  VECES ENCONTRADO: 21


