REPORTE PÁGINA WEB: https://www.endesaclientes.com/hogares/mantenimiento.html
FECHA EVALUACIÓN: 2018-11-05

PROBLEMAS
Missing form label	  VECES ENCONTRADO: 2
Empty heading	  VECES ENCONTRADO: 4
Empty link	  VECES ENCONTRADO: 1



ALERTAS
A nearby image has the same alternative text	  VECES ENCONTRADO: 7
Noscript element	  VECES ENCONTRADO: 2
Redundant title text	  VECES ENCONTRADO: 14
Link to PDF document	  VECES ENCONTRADO: 9
Possible heading	  VECES ENCONTRADO: 4
Very small text	  VECES ENCONTRADO: 6
Skipped heading level	  VECES ENCONTRADO: 3



CARACTERISTICAS
Linked image with alternative text	  VECES ENCONTRADO: 5
Alternative text	  VECES ENCONTRADO: 13
Null or empty alternative text	  VECES ENCONTRADO: 11



PROBLEMAS DE CONTRASTE
Very Low Contrast	  VECES ENCONTRADO: 17



